############
#..........#
#..........#
#..........#
#....@.....#
#..........#
#..........#
#..........#
############