############
#......##..#
#.......##.#
#..####....#
#.#..@#....#
#.#...#.#..#
#.##...##..#
#...##.....#
############